{
    "R": 0,
    "60": 1,
    "59": 2,
    "74": 3,
    "65": 4,
    "54": 5,
    "69": 6,
    "70": 7,
    "64": 8,
    "57": 9,
    "75": 10,
    "77": 11,
    "58": 12,
    "66": 13,
    "62": 14,
    "-": 15,
    "73": 16,
    "81": 17,
    "84": 18,
    "52": 19,
    "67": 20,
    "48": 21,
    "76": 22,
    "68": 23,
    "/": 24,
    "53": 25,
    "63": 26,
    "50": 27,
    "83": 28,
    "72": 29,
    "71": 30,
    "79": 31,
    "55": 32,
    "78": 33
}